"101","1","","","","",""
"","1","","","","",""
"","","1","","","",""
"","","","1","","",""
"","","","","1","",""
"","","","","","1",""
"","","","","","","102"