101,0,0,0,102,1,51
1,0,0,0,0,0,1
2,0,0,0,0,0,2
1,0,0,0,0,0,1
2,0,0,0,2,1,51
1,0,0,0,1,0,0
3,0,0,0,3,1,2
1,0,0,0,0,0,1
3,0,0,0,0,0,3
1,0,0,0,0,0,1
2,0,0,0,0,0,2
1,0,0,0,0,0,1
2,0,0,0,0,0,3
1,0,0,0,0,0,1
51,1,2,1,2,1,100
